40
40
########################################
#                                      -
############### ########################
# #           #             ####       #
# # ### # ### #############   ## #######
# # ### #  ## ###############    #######
# # # # #  ## #             ####       #
# # # # ##  # ######  ####      ###  # #
# # # # #  ## ######### ############ # #
# # # # # ### #########         #### # #
# #   # # ### ################# #### # #
# ##### # ###                 #  ### # #
# ##### # ### ################## ### # #
# ##### # ### ###############    ### # #
# ##### # ### ############### ###### # #
# ##### # ###              #  #      # #
# ##### # ### ######################## #
# ##### #   # #### ##### ############# #
# ##### ##### ####                     #
# ####    ### #### ################### #
# ####### ### #### #           ###     #
# ####### ###      ########### ### #####
# ####### ########        #### ### #####
# #######     ###########    # ###   ###
# ########### ################ #########
# #########                          ###
# ############################ #########
# ############################ #########
# ############################ ####### #
#                              ####### #
# ############################         #
# #################################### #
#######                       ######## #
# ##### #################### ##    ### #
#         #####         #### ## ###### #
# ####### ########## ####### ## ###### #
# #######            #######           #
######### ##############################
#                                     *#
########################################