10
10
##########
*        #
### ### ##
#    ## ##
# ##### ##
# #  ## ##
#    ## ##
#### ## ##
##-     ##
##########