7
7
#####-#
#     #
# #####
#     # 
##### #
#     #
#*#####