7
6
#####-#
#*# # #
#   # #
### # #
#     #
#######